-----------------------------------------------------                        
|...................................................|                        
|.----------S--.---...---------------------------|..|                        
|.||----   |.|--- |...|..........................|..|                        
|.||...| ---.-.|---...|.............<...............|                      
|.||...--|.....|....---..........................|..|.                     
|.||.....|-S-..|....|............................|..|..                      
|.|----..|..|..---..|----------------------------|..|-.                      
|.|   |..|..|....|..................................|...                     
|.|   |..|..|-----..------------------------------..|....                    
|.-----..---|.......|-----------------------     |..|.....                   
|...........|----.--|......................|     |..|.......                 
------------|...|.| --------------------.|.-------..|.....|..                
-------------...|.|---------------------.|..........|.....|....              
|...............|.S......................|-------------..-----...            
|.---------------.|---------------------.|.........................          
|.................|                    |.....................|........       
-------------------                    --------------------------------      
