----------------------------------------------------------------------------
|>.^S.|..|.....|  |.....-|      |................|   |......^........| |...|
|---|^|.--.---.|  |......--- ----..........-----.-----....---........---.-.|
|   |.|.|..| |.| --........................|   |.......---| |-...........--|
|   |...S..| |.| |.......-----.......------|   |--------..---......------- |
|----------- |^| |-......| |....|...-- |...-----................----       |
|.....S....---.| |.......| |....|...|  |..............-----------          |
|.....|.|......| |.....--- |......---  |....---.......|                    |
|.....|.|------| |....--   --....-- |-------- ----....---------------      |
|.....|--......---...-|     |...--  |.......|    |..................|      |
|..........||........-|    --...|   |.......|    |...||.............|      |
|.....|...-||-........------....|   |.......---- |...||.............--     |
|.....|--......---...^.......--------..........| |.......---------...--    |
|.....| |------| |--.......--|   |.........----- -----....| |.|  |....---  |
|.....| |......--| ------..| |----.........|       |.--------.-- |-.....---|
|------ |........|  |.|....| |.....----....---------...........---.........|
|       |........|  |...|..| |.....|  |-.............--------...........---|
|       --.....-----------^| |....-----.....----------     |......<..----  |
|        |..|..............| |.|..........|.|              |.|........|    |
----------------------------------------------------------------------------